0000000000000000
0000000000000000
0000000000000000
0000000000000000
0000000000000000
0003004003000000
0004035401030000
0001332446335000
0005443554112000
0005243654512000
1115223664552000
5553334442221110