00000000000000000000
00000000000000000000
00000000000000000000
00000000000000000000
00000000000000000000
00000000000000000000
00000000000000000000
00000000000000000000
00000000011100000000
00000001223221000000
00000012345432100000
00000012345432100000
00000031223221300000
00000022311132200000