0000000000000000
0000000000000000
0000000000000000
0000000000000000
0000000000000000
0000000000000000
0001234512345000
0002345123451000
0003451234512000
0004512345123000
0005123451234000
0001234512345000