0000000000000000
0000000000000000
0000000000000000
0000000000000000
0000000000000000
0000000000000000
0000000000000000
0000000740000000
0000005546000000
0000377231350000
0051235536671300
4445557272255445