00000000000000000000
00000000000000000000
00000000000000000000
00000000000000000000
00000000000000000000
00000000000000000000
00000000000000000000
00000000000000000000
00000123451234500000
00000234512345100000
00000345123451200000
00000451234512300000
00000512345123400000
00000123451234500000