00000000000000
00000000000000
00000000000000
00000000000000
00000000000000
00000000000000
00000000000000
00000000000000
00000000000000
00000007400000
00000055460000
00003772313500
00512355366713
44455572722554