0000000000000000
0000000000000000
0000000000000000
0000000000000000
0000000000000000
0000000000000000
0000000000000000
0000456712300000
0000567123400000
0000671234500000
0000712345600000
0000123456700000